{
  "levels": [
    {
      "id": 1,
      "name": "Tutorial - Easy Start",
      "width": 7,
      "height": 7,
      "grid": [
        [2, 2, 2, 2, 2, 2, 2],
        [2, 0, 0, 0, 0, 0, 2],
        [2, 0, 0, 0, 0, 0, 2],
        [2, 0, 0, 1, 0, 0, 2],
        [2, 0, 0, 0, 0, 0, 2],
        [2, 0, 0, 0, 0, 0, 2],
        [2, 2, 2, 2, 2, 2, 2]
      ],
      "playerStart": {"row": 1, "col": 1},
      "boxPositions": [{"row": 2, "col": 3}]
    },
    {
      "id": 2,
      "name": "L Shape",
      "width": 9,
      "height": 9,
      "grid": [
        [2, 2, 2, 2, 2, 2, 2, 2, 2],
        [2, 0, 0, 0, 2, 2, 2, 2, 2],
        [2, 0, 0, 0, 2, 2, 2, 2, 2],
        [2, 0, 0, 0, 2, 2, 2, 2, 2],
        [2, 0, 0, 0, 0, 0, 0, 0, 2],
        [2, 0, 0, 0, 0, 0, 0, 0, 2],
        [2, 1, 0, 0, 0, 0, 0, 1, 2],
        [2, 0, 0, 0, 0, 0, 0, 0, 2],
        [2, 2, 2, 2, 2, 2, 2, 2, 2]
      ],
      "playerStart": {"row": 1, "col": 1},
      "boxPositions": [
        {"row": 2, "col": 2},
        {"row": 5, "col": 6}
      ]
    },
    {
      "id": 3,
      "name": "Triangle",
      "width": 11,
      "height": 10,
      "grid": [
        [2, 2, 2, 2, 2, 2, 2, 2, 2, 2, 2],
        [2, 2, 2, 2, 2, 0, 2, 2, 2, 2, 2],
        [2, 2, 2, 2, 0, 0, 0, 2, 2, 2, 2],
        [2, 2, 2, 0, 0, 0, 0, 0, 2, 2, 2],
        [2, 2, 0, 0, 0, 0, 0, 0, 0, 2, 2],
        [2, 0, 0, 0, 0, 0, 0, 0, 0, 0, 2],
        [2, 0, 0, 0, 0, 0, 0, 0, 0, 0, 2],
        [2, 0, 0, 1, 0, 0, 0, 1, 0, 1, 2],
        [2, 0, 0, 0, 0, 0, 0, 0, 0, 0, 2],
        [2, 2, 2, 2, 2, 2, 2, 2, 2, 2, 2]
      ],
      "playerStart": {"row": 1, "col": 5},
      "boxPositions": [
        {"row": 3, "col": 4},
        {"row": 3, "col": 6},
        {"row": 5, "col": 3}
      ]
    },
    {
      "id": 4,
      "name": "Four Rooms",
      "width": 11,
      "height": 11,
      "grid": [
        [2, 2, 2, 2, 2, 2, 2, 2, 2, 2, 2],
        [2, 0, 0, 0, 0, 2, 0, 0, 0, 0, 2],
        [2, 0, 0, 0, 0, 2, 0, 0, 0, 0, 2],
        [2, 0, 0, 0, 0, 0, 0, 0, 0, 0, 2],
        [2, 0, 0, 0, 0, 0, 0, 0, 0, 0, 2],
        [2, 2, 2, 0, 0, 0, 0, 0, 2, 2, 2],
        [2, 0, 0, 0, 0, 0, 0, 0, 0, 0, 2],
        [2, 0, 0, 0, 0, 0, 0, 0, 0, 0, 2],
        [2, 0, 0, 0, 0, 2, 0, 0, 0, 0, 2],
        [2, 1, 0, 1, 0, 2, 0, 1, 0, 1, 2],
        [2, 2, 2, 2, 2, 2, 2, 2, 2, 2, 2]
      ],
      "playerStart": {"row": 5, "col": 5},
      "boxPositions": [
        {"row": 2, "col": 2},
        {"row": 2, "col": 8},
        {"row": 8, "col": 2},
        {"row": 8, "col": 8}
      ]
    },
    {
      "id": 5,
      "name": "Spiral",
      "width": 13,
      "height": 13,
      "grid": [
        [2, 2, 2, 2, 2, 2, 2, 2, 2, 2, 2, 2, 2],
        [2, 0, 0, 0, 0, 0, 0, 0, 0, 0, 0, 0, 2],
        [2, 0, 2, 0, 2, 2, 2, 2, 2, 0, 2, 0, 2],
        [2, 0, 0, 0, 0, 0, 0, 0, 0, 0, 0, 0, 2],
        [2, 0, 2, 0, 2, 0, 2, 0, 2, 0, 2, 0, 2],
        [2, 0, 2, 0, 0, 0, 0, 0, 0, 0, 2, 0, 2],
        [2, 0, 2, 0, 2, 0, 0, 0, 2, 0, 2, 0, 2],
        [2, 0, 2, 0, 0, 0, 0, 0, 0, 0, 2, 0, 2],
        [2, 0, 2, 0, 2, 0, 2, 0, 2, 0, 2, 0, 2],
        [2, 0, 0, 0, 0, 0, 0, 0, 0, 0, 0, 0, 2],
        [2, 0, 2, 0, 2, 2, 2, 2, 2, 0, 2, 0, 2],
        [2, 1, 0, 0, 1, 0, 0, 1, 0, 0, 1, 1, 2],
        [2, 2, 2, 2, 2, 2, 2, 2, 2, 2, 2, 2, 2]
      ],
      "playerStart": {"row": 6, "col": 6},
      "boxPositions": [
        {"row": 3, "col": 3},
        {"row": 3, "col": 5},
        {"row": 6, "col": 7},
        {"row": 9, "col": 6},
        {"row": 7, "col": 3}
      ]
    },
    {
      "id": 6,
      "name": "Zigzag",
      "width": 13,
      "height": 11,
      "grid": [
        [2, 2, 2, 2, 2, 2, 2, 2, 2, 2, 2, 2, 2],
        [2, 0, 0, 0, 0, 0, 2, 2, 2, 2, 2, 2, 2],
        [2, 0, 0, 0, 0, 0, 0, 0, 0, 0, 2, 2, 2],
        [2, 2, 2, 0, 0, 0, 0, 0, 0, 0, 0, 0, 2],
        [2, 2, 2, 2, 2, 2, 0, 0, 0, 0, 0, 0, 2],
        [2, 0, 0, 0, 0, 0, 0, 0, 0, 2, 2, 2, 2],
        [2, 0, 0, 0, 0, 0, 0, 0, 0, 0, 2, 2, 2],
        [2, 2, 2, 0, 0, 0, 0, 0, 0, 0, 0, 0, 2],
        [2, 2, 2, 2, 2, 2, 0, 0, 0, 0, 0, 0, 2],
        [2, 2, 2, 2, 2, 2, 1, 1, 0, 1, 1, 1, 2],
        [2, 2, 2, 2, 2, 2, 2, 2, 2, 2, 2, 2, 2]
      ],
      "playerStart": {"row": 1, "col": 2},
      "boxPositions": [
        {"row": 2, "col": 3},
        {"row": 3, "col": 7},
        {"row": 4, "col": 9},
        {"row": 6, "col": 4},
        {"row": 7, "col": 8}
      ]
    },
    {
      "id": 7,
      "name": "Diamond",
      "width": 13,
      "height": 13,
      "grid": [
        [2, 2, 2, 2, 2, 2, 2, 2, 2, 2, 2, 2, 2],
        [2, 2, 2, 2, 2, 2, 0, 2, 2, 2, 2, 2, 2],
        [2, 2, 2, 2, 2, 0, 0, 0, 2, 2, 2, 2, 2],
        [2, 2, 2, 2, 0, 0, 0, 0, 0, 2, 2, 2, 2],
        [2, 2, 2, 0, 0, 0, 0, 0, 0, 0, 2, 2, 2],
        [2, 2, 0, 0, 0, 0, 0, 0, 0, 0, 0, 2, 2],
        [2, 0, 0, 0, 0, 0, 0, 0, 0, 0, 0, 0, 2],
        [2, 2, 0, 0, 0, 0, 0, 0, 0, 0, 0, 2, 2],
        [2, 2, 2, 0, 0, 0, 0, 0, 0, 0, 2, 2, 2],
        [2, 2, 2, 2, 0, 0, 0, 0, 0, 2, 2, 2, 2],
        [2, 2, 2, 2, 2, 0, 0, 0, 2, 2, 2, 2, 2],
        [2, 2, 2, 2, 2, 1, 1, 1, 2, 2, 2, 2, 2],
        [2, 2, 2, 2, 2, 2, 1, 2, 2, 2, 2, 2, 2]
      ],
      "playerStart": {"row": 6, "col": 6},
      "boxPositions": [
        {"row": 6, "col": 3},
        {"row": 6, "col": 9},
        {"row": 8, "col": 5},
        {"row": 8, "col": 7}
      ]
    },
    {
      "id": 8,
      "name": "Checkerboard",
      "width": 13,
      "height": 13,
      "grid": [
        [2, 2, 2, 2, 2, 2, 2, 2, 2, 2, 2, 2, 2],
        [2, 0, 0, 0, 0, 0, 0, 0, 0, 0, 0, 0, 2],
        [2, 0, 2, 0, 2, 0, 2, 0, 2, 0, 2, 0, 2],
        [2, 0, 0, 0, 0, 0, 0, 0, 0, 0, 0, 0, 2],
        [2, 0, 2, 0, 2, 0, 2, 0, 2, 0, 2, 0, 2],
        [2, 0, 0, 0, 0, 0, 0, 0, 0, 0, 0, 0, 2],
        [2, 0, 2, 0, 2, 0, 2, 0, 2, 0, 2, 0, 2],
        [2, 0, 0, 0, 0, 0, 0, 0, 0, 0, 0, 0, 2],
        [2, 0, 2, 0, 2, 0, 2, 0, 2, 0, 2, 0, 2],
        [2, 0, 0, 0, 0, 0, 0, 0, 0, 0, 0, 0, 2],
        [2, 0, 2, 0, 2, 0, 2, 0, 2, 0, 2, 0, 2],
        [2, 1, 0, 1, 0, 1, 0, 1, 0, 1, 0, 1, 2],
        [2, 2, 2, 2, 2, 2, 2, 2, 2, 2, 2, 2, 2]
      ],
      "playerStart": {"row": 1, "col": 1},
      "boxPositions": [
        {"row": 2, "col": 3},
        {"row": 2, "col": 9},
        {"row": 4, "col": 5},
        {"row": 6, "col": 3},
        {"row": 6, "col": 11},
        {"row": 8, "col": 7}
      ]
    },
    {
      "id": 9,
      "name": "OpenField5_Clustered",
      "width": 15,
      "height": 15,
      "grid": [
        [2,2,2,2,2,2,2,2,2,2,2,2,2,2,2],
        [2,0,0,0,0,2,2,0,0,0,2,2,0,0,2],
        [2,0,0,1,0,0,0,0,0,0,0,1,0,0,2],
        [2,0,0,0,0,2,0,0,2,0,0,0,0,0,2],
        [2,0,2,2,0,0,0,0,0,0,2,2,2,0,2],
        [2,0,0,0,0,0,0,0,0,0,0,0,0,0,2],
        [2,0,0,0,0,0,1,0,1,0,0,2,0,0,2],
        [2,0,0,0,0,2,0,0,0,0,0,2,0,0,2],
        [2,0,2,2,2,0,0,0,0,0,2,2,2,0,2],
        [2,0,0,0,0,0,2,0,2,0,0,0,0,0,2],
        [2,0,0,1,0,0,0,0,0,0,0,1,0,0,2],
        [2,0,0,0,0,2,2,0,0,2,2,0,0,0,2],
        [2,0,0,0,0,0,0,0,0,0,0,0,0,0,2],
        [2,0,2,2,0,0,0,2,2,0,0,0,2,0,2],
        [2,2,2,2,2,2,2,2,2,2,2,2,2,2,2]
      ],
      "playerStart": { "row": 7, "col": 7 },
      "boxPositions": [
        { "row": 3, "col": 6 },
        { "row": 6, "col": 4 },
        { "row": 6, "col": 10 },
        { "row": 10, "col": 6 },
        { "row": 10, "col": 8 },
        {"row": 2, "col":8  }
      ]
    },
    {
      "id": 10,
      "name": "Ultimate Challenge",
      "width": 11,
      "height": 9,
      "grid": [
        [2, 2, 2, 2, 2, 2, 2, 2, 2, 2, 2],
        [2, 2, 2, 2, 0, 0, 0, 2, 2, 2, 2],
        [2, 0, 0, 2, 0, 0, 0, 2, 2, 2, 2],
        [2, 0, 0, 0, 0, 0, 0, 0, 0, 0, 2],
        [2, 0, 0, 0, 2, 0, 0, 0, 2, 0, 2],
        [2, 2, 2, 0, 2, 0, 0, 0, 2, 0, 2],
        [2, 0, 0, 0, 2, 2, 2, 2, 2, 0, 2],
        [2, 0, 0, 0, 1, 1, 1, 1, 1, 0, 2],
        [2, 2, 2, 2, 2, 2, 2, 2, 2, 2, 2]
      ],
      "playerStart": {"row": 4, "col": 1},
      "boxPositions": [
        {"row": 2, "col": 4},
        {"row": 3, "col": 2},
        {"row": 3, "col": 3},
        {"row": 4, "col": 5},
        {"row": 4, "col": 7}
      ]
    }
  ]
}
