{
  "levels": [
    {
      "id": 1,
      "width": 8,
      "height": 8,
      "grid": [
        [2, 2, 2, 2, 2, 2, 2, 2],
        [2, 0, 0, 0, 0, 0, 0, 2],
        [2, 0, 0, 0, 1, 0, 0, 2],
        [2, 0, 0, 0, 0, 0, 0, 2],
        [2, 0, 0, 0, 0, 0, 0, 2],
        [2, 0, 0, 0, 0, 0, 0, 2],
        [2, 0, 0, 0, 0, 0, 0, 2],
        [2, 2, 2, 2, 2, 2, 2, 2]
      ],
      "playerStart": {"row": 1, "col": 1},
      "boxPositions": [{"row": 2, "col": 3}]
    },
    {
      "id": 2,
      "width": 10,
      "height": 8,
      "grid": [
        [2, 2, 2, 2, 2, 2, 2, 2, 2, 2],
        [2, 0, 0, 0, 0, 0, 0, 0, 0, 2],
        [2, 0, 0, 0, 0, 0, 0, 1, 0, 2],
        [2, 0, 0, 0, 2, 2, 0, 0, 0, 2],
        [2, 0, 0, 0, 2, 2, 0, 0, 0, 2],
        [2, 0, 0, 0, 0, 0, 0, 1, 0, 2],
        [2, 0, 0, 0, 0, 0, 0, 0, 0, 2],
        [2, 2, 2, 2, 2, 2, 2, 2, 2, 2]
      ],
      "playerStart": {"row": 1, "col": 1},
      "boxPositions": [
        {"row": 2, "col": 3},
        {"row": 5, "col": 3}
      ]
    },
    {
      "id": 3,
      "width": 9,
      "height": 9,
      "grid": [
        [2, 2, 2, 2, 2, 2, 2, 2, 2],
        [2, 0, 0, 0, 0, 0, 0, 0, 2],
        [2, 0, 2, 2, 2, 2, 2, 0, 2],
        [2, 0, 2, 1, 0, 1, 2, 0, 2],
        [2, 0, 2, 0, 0, 0, 2, 0, 2],
        [2, 0, 2, 1, 0, 1, 2, 0, 2],
        [2, 0, 2, 2, 2, 2, 2, 0, 2],
        [2, 0, 0, 0, 0, 0, 0, 0, 2],
        [2, 2, 2, 2, 2, 2, 2, 2, 2]
      ],
      "playerStart": {"row": 4, "col": 4},
      "boxPositions": [
        {"row": 3, "col": 4},
        {"row": 4, "col": 3},
        {"row": 4, "col": 5},
        {"row": 5, "col": 4}
      ]
    },
    {
      "id": 4,
      "width": 11,
      "height": 9,
      "grid": [
        [2, 2, 2, 2, 2, 2, 2, 2, 2, 2, 2],
        [2, 0, 0, 0, 0, 2, 0, 0, 0, 0, 2],
        [2, 0, 1, 0, 0, 2, 0, 0, 1, 0, 2],
        [2, 0, 0, 0, 0, 0, 0, 0, 0, 0, 2],
        [2, 0, 0, 0, 2, 2, 2, 0, 0, 0, 2],
        [2, 0, 0, 0, 0, 0, 0, 0, 0, 0, 2],
        [2, 0, 1, 0, 0, 2, 0, 0, 1, 0, 2],
        [2, 0, 0, 0, 0, 2, 0, 0, 0, 0, 2],
        [2, 2, 2, 2, 2, 2, 2, 2, 2, 2, 2]
      ],
      "playerStart": {"row": 4, "col": 5},
      "boxPositions": [
        {"row": 2, "col": 2},
        {"row": 2, "col": 8},
        {"row": 6, "col": 2},
        {"row": 6, "col": 8}
      ]
    },
    {
      "id": 5,
      "width": 12,
      "height": 10,
      "grid": [
        [2, 2, 2, 2, 2, 2, 2, 2, 2, 2, 2, 2],
        [2, 0, 0, 0, 0, 0, 0, 0, 0, 0, 0, 2],
        [2, 0, 2, 2, 0, 0, 0, 0, 2, 2, 0, 2],
        [2, 0, 2, 1, 0, 0, 0, 0, 1, 2, 0, 2],
        [2, 0, 0, 0, 0, 2, 2, 0, 0, 0, 0, 2],
        [2, 0, 0, 0, 0, 2, 2, 0, 0, 0, 0, 2],
        [2, 0, 2, 1, 0, 0, 0, 0, 1, 2, 0, 2],
        [2, 0, 2, 2, 0, 0, 0, 0, 2, 2, 0, 2],
        [2, 0, 0, 0, 0, 0, 0, 0, 0, 0, 0, 2],
        [2, 2, 2, 2, 2, 2, 2, 2, 2, 2, 2, 2]
      ],
      "playerStart": {"row": 5, "col": 6},
      "boxPositions": [
        {"row": 3, "col": 4},
        {"row": 3, "col": 7},
        {"row": 6, "col": 4},
        {"row": 6, "col": 7},
        {"row": 4, "col": 5}
      ]
    }
  ]
}
